"edon","seccion","munn","inegi","ife","escenario1","pan1","pri1","prd1","pt1","pvem1","conve1","escenario2","pan2","pri2","prd2","pt2","pvem2","conve2","escenario3"
6,1,1,6002,6001,2,2,2,2,2,2,2,2,2,2,2,2,2,2,1
6,2,1,6002,6001,2,2,2,2,2,2,2,2,2,2,2,2,2,2,1
6,3,1,6002,6001,2,2,2,2,2,2,2,2,2,2,2,2,2,2,1
6,4,1,6002,6001,2,2,2,2,2,2,2,2,2,2,2,2,2,2,1
6,5,1,6002,6001,2,2,2,2,2,2,2,2,2,2,2,2,2,2,1
6,6,1,6002,6001,2,2,2,2,2,2,2,2,2,2,2,2,2,2,1
6,7,1,6002,6001,2,2,2,2,2,2,2,2,2,2,2,2,2,2,1
6,8,1,6002,6001,2,2,2,2,2,2,2,2,2,2,2,2,2,2,1
6,9,1,6002,6001,2,2,2,2,2,2,2,2,2,2,2,2,2,2,1
6,10,1,6002,6001,2,2,2,2,2,2,2,2,2,2,2,2,2,2,1
6,11,1,6002,6001,2,2,2,2,2,2,2,2,2,2,2,2,2,2,1
6,12,1,6002,6001,2,2,2,2,2,2,2,2,2,2,2,2,2,2,1
6,13,1,6002,6001,2,2,2,2,2,2,2,2,2,2,2,2,2,2,1
6,14,1,6002,6001,2,2,2,2,2,2,2,2,2,2,2,2,2,2,1
6,15,1,6002,6001,2,2,2,2,2,2,2,2,2,2,2,2,2,2,1
6,16,1,6002,6001,2,2,2,2,2,2,2,2,2,2,2,2,2,2,1
6,17,1,6002,6001,2,2,2,2,2,2,2,2,2,2,2,2,2,2,1
6,18,1,6002,6001,2,2,2,2,2,2,2,2,2,2,2,2,2,2,1
6,19,1,6002,6001,2,2,2,2,2,2,2,2,2,2,2,2,2,2,1
6,20,1,6002,6001,2,2,2,2,2,2,2,2,2,2,2,2,2,2,1
6,21,1,6002,6001,2,2,2,2,2,2,2,2,2,2,2,2,2,2,1
6,22,1,6002,6001,2,2,2,2,2,2,2,2,2,2,2,2,2,2,1
6,23,1,6002,6001,2,2,2,2,2,2,2,2,2,2,2,2,2,2,1
6,24,1,6002,6001,2,2,2,2,2,2,2,2,2,2,2,2,2,2,1
6,25,1,6002,6001,2,2,2,2,2,2,2,2,2,2,2,2,2,2,1
6,26,1,6002,6001,2,2,2,2,2,2,2,2,2,2,2,2,2,2,1
6,27,1,6002,6001,2,2,2,2,2,2,2,2,2,2,2,2,2,2,1
6,28,1,6002,6001,2,2,2,2,2,2,2,2,2,2,2,2,2,2,1
6,29,1,6002,6001,2,2,2,2,2,2,2,2,2,2,2,2,2,2,1
6,30,1,6002,6001,2,2,2,2,2,2,2,2,2,2,2,2,2,2,1
6,31,1,6002,6001,2,2,2,2,2,2,2,2,2,2,2,2,2,2,1
6,32,1,6002,6001,2,2,2,2,2,2,2,2,2,2,2,2,2,2,1
6,33,1,6002,6001,2,2,2,2,2,2,2,2,2,2,2,2,2,2,1
6,34,1,6002,6001,2,2,2,2,2,2,2,2,2,2,2,2,2,2,1
6,35,1,6002,6001,2,2,2,2,2,2,2,2,2,2,2,2,2,2,1
6,36,1,6002,6001,2,2,2,2,2,2,2,2,2,2,2,2,2,2,1
6,37,1,6002,6001,2,2,2,2,2,2,2,2,2,2,2,2,2,2,1
6,38,1,6002,6001,2,2,2,2,2,2,2,2,2,2,2,2,2,2,1
6,39,1,6002,6001,2,2,2,2,2,2,2,2,2,2,2,2,2,2,1
6,40,1,6002,6001,2,2,2,2,2,2,2,2,2,2,2,2,2,2,1
6,41,1,6002,6001,2,2,2,2,2,2,2,2,2,2,2,2,2,2,1
6,42,1,6002,6001,2,2,2,2,2,2,2,2,2,2,2,2,2,2,1
6,43,1,6002,6001,2,2,2,2,2,2,2,2,2,2,2,2,2,2,1
6,44,1,6002,6001,2,2,2,2,2,2,2,2,2,2,2,2,2,2,1
6,45,1,6002,6001,2,2,2,2,2,2,2,2,2,2,2,2,2,2,1
6,46,1,6002,6001,2,2,2,2,2,2,2,2,2,2,2,2,2,2,1
6,47,1,6002,6001,2,2,2,2,2,2,2,2,2,2,2,2,2,2,1
6,48,1,6002,6001,2,2,2,2,2,2,2,2,2,2,2,2,2,2,1
6,49,1,6002,6001,2,2,2,2,2,2,2,2,2,2,2,2,2,2,1
6,50,1,6002,6001,2,2,2,2,2,2,2,2,2,2,2,2,2,2,1
6,51,1,6002,6001,2,2,2,2,2,2,2,2,2,2,2,2,2,2,1
6,52,1,6002,6001,2,2,2,2,2,2,2,2,2,2,2,2,2,2,1
6,53,1,6002,6001,2,2,2,2,2,2,2,2,2,2,2,2,2,2,1
6,54,1,6002,6001,2,2,2,2,2,2,2,2,2,2,2,2,2,2,1
6,55,1,6002,6001,2,2,2,2,2,2,2,2,2,2,2,2,2,2,1
6,56,1,6002,6001,2,2,2,2,2,2,2,2,2,2,2,2,2,2,1
6,57,1,6002,6001,2,2,2,2,2,2,2,2,2,2,2,2,2,2,1
6,58,1,6002,6001,2,2,2,2,2,2,2,2,2,2,2,2,2,2,1
6,59,1,6002,6001,2,2,2,2,2,2,2,2,2,2,2,2,2,2,1
6,60,1,6002,6001,2,2,2,2,2,2,2,2,2,2,2,2,2,2,1
6,61,1,6002,6001,2,2,2,2,2,2,2,2,2,2,2,2,2,2,1
6,62,1,6002,6001,2,2,2,2,2,2,2,2,2,2,2,2,2,2,1
6,63,1,6002,6001,2,2,2,2,2,2,2,2,2,2,2,2,2,2,1
6,64,1,6002,6001,2,2,2,2,2,2,2,2,2,2,2,2,2,2,1
6,65,1,6002,6001,2,2,2,2,2,2,2,2,2,2,2,2,2,2,1
6,66,1,6002,6001,2,2,2,2,2,2,2,2,2,2,2,2,2,2,1
6,67,1,6002,6001,2,2,2,2,2,2,2,2,2,2,2,2,2,2,1
6,68,1,6002,6001,2,2,2,2,2,2,2,2,2,2,2,2,2,2,1
6,69,1,6002,6001,2,2,2,2,2,2,2,2,2,2,2,2,2,2,1
6,70,1,6002,6001,2,2,2,2,2,2,2,2,2,2,2,2,2,2,1
6,71,1,6002,6001,2,2,2,2,2,2,2,2,2,2,2,2,2,2,1
6,72,1,6002,6001,2,2,2,2,2,2,2,2,2,2,2,2,2,2,1
6,73,1,6002,6001,2,2,2,2,2,2,2,2,2,2,2,2,2,2,1
6,74,1,6002,6001,2,2,2,2,2,2,2,2,2,2,2,2,2,2,1
6,75,1,6002,6001,2,2,2,2,2,2,2,2,2,2,2,2,2,2,1
6,76,1,6002,6001,2,2,2,2,2,2,2,2,2,2,2,2,2,2,1
6,77,1,6002,6001,2,2,2,2,2,2,2,2,2,2,2,2,2,2,1
6,78,1,6002,6001,2,2,2,2,2,2,2,2,2,2,2,2,2,2,1
6,79,1,6002,6001,2,2,2,2,2,2,2,2,2,2,2,2,2,2,1
6,80,1,6002,6001,2,2,2,2,2,2,2,2,2,2,2,2,2,2,1
6,81,1,6002,6001,2,2,2,2,2,2,2,2,2,2,2,2,2,2,1
6,82,1,6002,6001,2,2,2,2,2,2,2,2,2,2,2,2,2,2,1
6,83,1,6002,6001,2,2,2,2,2,2,2,2,2,2,2,2,2,2,1
6,84,1,6002,6001,2,2,2,2,2,2,2,2,2,2,2,2,2,2,1
6,85,1,6002,6001,2,2,2,2,2,2,2,2,2,2,2,2,2,2,1
6,86,1,6002,6001,2,2,2,2,2,2,2,2,2,2,2,2,2,2,1
6,87,1,6002,6001,2,2,2,2,2,2,2,2,2,2,2,2,2,2,1
6,88,1,6002,6001,2,2,2,2,2,2,2,2,2,2,2,2,2,2,1
6,89,1,6002,6001,2,2,2,2,2,2,2,2,2,2,2,2,2,2,1
6,90,1,6002,6001,2,2,2,2,2,2,2,2,2,2,2,2,2,2,1
6,91,1,6002,6001,2,2,2,2,2,2,2,2,2,2,2,2,2,2,1
6,92,2,6003,6002,2,2,2,2,2,2,2,2,2,2,2,2,2,2,1
6,93,2,6003,6002,2,2,2,2,2,2,2,2,2,2,2,2,2,2,1
6,94,2,6003,6002,2,2,2,2,2,2,2,2,2,2,2,2,2,2,1
6,95,2,6003,6002,2,2,2,2,2,2,2,2,2,2,2,2,2,2,1
6,96,2,6003,6002,2,2,2,2,2,2,2,2,2,2,2,2,2,2,1
6,97,2,6003,6002,2,2,2,2,2,2,2,2,2,2,2,2,2,2,1
6,98,2,6003,6002,2,2,2,2,2,2,2,2,2,2,2,2,2,2,1
6,99,2,6003,6002,2,2,2,2,2,2,2,2,2,2,2,2,2,2,1
6,100,2,6003,6002,2,2,2,2,2,2,2,2,2,2,2,2,2,2,1
6,101,2,6003,6002,2,2,2,2,2,2,2,2,2,2,2,2,2,2,1
6,102,2,6003,6002,2,2,2,2,2,2,2,2,2,2,2,2,2,2,1
6,103,2,6003,6002,2,2,2,2,2,2,2,2,2,2,2,2,2,2,1
6,104,2,6003,6002,2,2,2,2,2,2,2,2,2,2,2,2,2,2,1
6,105,3,6004,6003,1,2,1,1,1,1,1,2,2,2,2,2,2,2,1
6,106,3,6004,6003,1,2,1,1,1,1,1,2,2,2,2,2,2,2,1
6,107,3,6004,6003,1,2,1,1,1,1,1,2,2,2,2,2,2,2,1
6,108,3,6004,6003,1,2,1,1,1,1,1,2,2,2,2,2,2,2,1
6,109,3,6004,6003,1,2,1,1,1,1,1,2,2,2,2,2,2,2,1
6,110,3,6004,6003,1,2,1,1,1,1,1,2,2,2,2,2,2,2,1
6,111,3,6004,6003,1,2,1,1,1,1,1,2,2,2,2,2,2,2,1
6,112,3,6004,6003,1,2,1,1,1,1,1,2,2,2,2,2,2,2,1
6,113,3,6004,6003,1,2,1,1,1,1,1,2,2,2,2,2,2,2,1
6,114,3,6004,6003,1,2,1,1,1,1,1,2,2,2,2,2,2,2,1
6,115,3,6004,6003,1,2,1,1,1,1,1,2,2,2,2,2,2,2,1
6,116,3,6004,6003,1,2,1,1,1,1,1,2,2,2,2,2,2,2,1
6,117,3,6004,6003,1,2,1,1,1,1,1,2,2,2,2,2,2,2,1
6,118,3,6004,6003,1,2,1,1,1,1,1,2,2,2,2,2,2,2,1
6,119,3,6004,6003,1,2,1,1,1,1,1,2,2,2,2,2,2,2,1
6,120,4,6005,6004,2,2,2,2,2,2,2,2,2,2,2,2,2,2,1
6,121,4,6005,6004,2,2,2,2,2,2,2,2,2,2,2,2,2,2,1
6,122,4,6005,6004,2,2,2,2,2,2,2,2,2,2,2,2,2,2,1
6,123,4,6005,6004,2,2,2,2,2,2,2,2,2,2,2,2,2,2,1
6,124,4,6005,6004,2,2,2,2,2,2,2,2,2,2,2,2,2,2,1
6,125,4,6005,6004,2,2,2,2,2,2,2,2,2,2,2,2,2,2,1
6,126,4,6005,6004,2,2,2,2,2,2,2,2,2,2,2,2,2,2,1
6,127,4,6005,6004,2,2,2,2,2,2,2,2,2,2,2,2,2,2,1
6,128,4,6005,6004,2,2,2,2,2,2,2,2,2,2,2,2,2,2,1
6,129,4,6005,6004,2,2,2,2,2,2,2,2,2,2,2,2,2,2,1
6,130,4,6005,6004,2,2,2,2,2,2,2,2,2,2,2,2,2,2,1
6,131,4,6005,6004,2,2,2,2,2,2,2,2,2,2,2,2,2,2,1
6,132,4,6005,6004,2,2,2,2,2,2,2,2,2,2,2,2,2,2,1
6,133,4,6005,6004,2,2,2,2,2,2,2,2,2,2,2,2,2,2,1
6,134,4,6005,6004,2,2,2,2,2,2,2,2,2,2,2,2,2,2,1
6,135,4,6005,6004,2,2,2,2,2,2,2,2,2,2,2,2,2,2,1
6,136,4,6005,6004,2,2,2,2,2,2,2,2,2,2,2,2,2,2,1
6,137,4,6005,6004,2,2,2,2,2,2,2,2,2,2,2,2,2,2,1
6,138,5,6010,6005,2,2,2,2,2,2,2,2,2,2,2,2,2,2,1
6,139,5,6010,6005,2,2,2,2,2,2,2,2,2,2,2,2,2,2,1
6,140,5,6010,6005,2,2,2,2,2,2,2,2,2,2,2,2,2,2,1
6,141,5,6010,6005,2,2,2,2,2,2,2,2,2,2,2,2,2,2,1
6,142,5,6010,6005,2,2,2,2,2,2,2,2,2,2,2,2,2,2,1
6,143,5,6010,6005,2,2,2,2,2,2,2,2,2,2,2,2,2,2,1
6,144,5,6010,6005,2,2,2,2,2,2,2,2,2,2,2,2,2,2,1
6,145,5,6010,6005,2,2,2,2,2,2,2,2,2,2,2,2,2,2,1
6,146,5,6010,6005,2,2,2,2,2,2,2,2,2,2,2,2,2,2,1
6,147,5,6010,6005,2,2,2,2,2,2,2,2,2,2,2,2,2,2,1
6,148,5,6010,6005,2,2,2,2,2,2,2,2,2,2,2,2,2,2,1
6,149,5,6010,6005,2,2,2,2,2,2,2,2,2,2,2,2,2,2,1
6,150,5,6010,6005,2,2,2,2,2,2,2,2,2,2,2,2,2,2,1
6,151,5,6010,6005,2,2,2,2,2,2,2,2,2,2,2,2,2,2,1
6,152,5,6010,6005,2,2,2,2,2,2,2,2,2,2,2,2,2,2,1
6,153,5,6010,6005,2,2,2,2,2,2,2,2,2,2,2,2,2,2,1
6,154,5,6010,6005,2,2,2,2,2,2,2,2,2,2,2,2,2,2,1
6,155,5,6010,6005,2,2,2,2,2,2,2,2,2,2,2,2,2,2,1
6,156,5,6010,6005,2,2,2,2,2,2,2,2,2,2,2,2,2,2,1
6,157,5,6010,6005,2,2,2,2,2,2,2,2,2,2,2,2,2,2,1
6,158,5,6010,6005,2,2,2,2,2,2,2,2,2,2,2,2,2,2,1
6,159,5,6010,6005,2,2,2,2,2,2,2,2,2,2,2,2,2,2,1
6,160,5,6010,6005,2,2,2,2,2,2,2,2,2,2,2,2,2,2,1
6,161,5,6010,6005,2,2,2,2,2,2,2,2,2,2,2,2,2,2,1
6,162,5,6010,6005,2,2,2,2,2,2,2,2,2,2,2,2,2,2,1
6,163,5,6010,6005,2,2,2,2,2,2,2,2,2,2,2,2,2,2,1
6,164,5,6010,6005,2,2,2,2,2,2,2,2,2,2,2,2,2,2,1
6,165,5,6010,6005,2,2,2,2,2,2,2,2,2,2,2,2,2,2,1
6,166,5,6010,6005,2,2,2,2,2,2,2,2,2,2,2,2,2,2,1
6,167,5,6010,6005,2,2,2,2,2,2,2,2,2,2,2,2,2,2,1
6,168,5,6010,6005,2,2,2,2,2,2,2,2,2,2,2,2,2,2,1
6,169,5,6010,6005,2,2,2,2,2,2,2,2,2,2,2,2,2,2,1
6,170,6,6001,6006,1,1,1,1,1,1,1,1,1,1,1,1,1,1,2
6,171,6,6001,6006,1,1,1,1,1,1,1,1,1,1,1,1,1,1,2
6,172,6,6001,6006,1,1,1,1,1,1,1,1,1,1,1,1,1,1,2
6,173,6,6001,6006,1,1,1,1,1,1,1,1,1,1,1,1,1,1,2
6,174,6,6001,6006,1,1,1,1,1,1,1,1,1,1,1,1,1,1,2
6,175,6,6001,6006,1,1,1,1,1,1,1,1,1,1,1,1,1,1,2
6,176,6,6001,6006,1,1,1,1,1,1,1,1,1,1,1,1,1,1,2
6,177,6,6001,6006,1,1,1,1,1,1,1,1,1,1,1,1,1,1,2
6,178,6,6001,6006,1,1,1,1,1,1,1,1,1,1,1,1,1,1,2
6,179,6,6001,6006,1,1,1,1,1,1,1,1,1,1,1,1,1,1,2
6,180,6,6001,6006,1,1,1,1,1,1,1,1,1,1,1,1,1,1,2
6,181,6,6001,6006,1,1,1,1,1,1,1,1,1,1,1,1,1,1,2
6,182,6,6001,6006,1,1,1,1,1,1,1,1,1,1,1,1,1,1,2
6,183,6,6001,6006,1,1,1,1,1,1,1,1,1,1,1,1,1,1,2
6,184,6,6001,6006,1,1,1,1,1,1,1,1,1,1,1,1,1,1,2
6,185,6,6001,6006,1,1,1,1,1,1,1,1,1,1,1,1,1,1,2
6,186,6,6001,6006,1,1,1,1,1,1,1,1,1,1,1,1,1,1,2
6,187,6,6001,6006,1,1,1,1,1,1,1,1,1,1,1,1,1,1,2
6,188,6,6001,6006,1,1,1,1,1,1,1,1,1,1,1,1,1,1,2
6,189,6,6001,6006,1,1,1,1,1,1,1,1,1,1,1,1,1,1,2
6,190,6,6001,6006,1,1,1,1,1,1,1,1,1,1,1,1,1,1,2
6,191,7,6006,6007,2,1,2,2,2,2,2,2,2,2,2,2,2,2,1
6,192,7,6006,6007,2,1,2,2,2,2,2,2,2,2,2,2,2,2,1
6,193,7,6006,6007,2,1,2,2,2,2,2,2,2,2,2,2,2,2,1
6,194,7,6006,6007,2,1,2,2,2,2,2,2,2,2,2,2,2,2,1
6,195,7,6006,6007,2,1,2,2,2,2,2,2,2,2,2,2,2,2,1
6,196,7,6006,6007,2,1,2,2,2,2,2,2,2,2,2,2,2,2,1
6,197,7,6006,6007,2,1,2,2,2,2,2,2,2,2,2,2,2,2,1
6,198,7,6006,6007,2,1,2,2,2,2,2,2,2,2,2,2,2,2,1
6,199,7,6006,6007,2,1,2,2,2,2,2,2,2,2,2,2,2,2,1
6,200,8,6007,6008,1,1,1,1,1,1,1,1,1,1,1,1,1,1,2
6,201,8,6007,6008,1,1,1,1,1,1,1,1,1,1,1,1,1,1,2
6,202,8,6007,6008,1,1,1,1,1,1,1,1,1,1,1,1,1,1,2
6,203,8,6007,6008,1,1,1,1,1,1,1,1,1,1,1,1,1,1,2
6,204,8,6007,6008,1,1,1,1,1,1,1,1,1,1,1,1,1,1,2
6,205,8,6007,6008,1,1,1,1,1,1,1,1,1,1,1,1,1,1,2
6,206,8,6007,6008,1,1,1,1,1,1,1,1,1,1,1,1,1,1,2
6,207,8,6007,6008,1,1,1,1,1,1,1,1,1,1,1,1,1,1,2
6,208,8,6007,6008,1,1,1,1,1,1,1,1,1,1,1,1,1,1,2
6,209,8,6007,6008,1,1,1,1,1,1,1,1,1,1,1,1,1,1,2
6,210,8,6007,6008,1,1,1,1,1,1,1,1,1,1,1,1,1,1,2
6,211,8,6007,6008,1,1,1,1,1,1,1,1,1,1,1,1,1,1,2
6,212,8,6007,6008,1,1,1,1,1,1,1,1,1,1,1,1,1,1,2
6,213,8,6007,6008,1,1,1,1,1,1,1,1,1,1,1,1,1,1,2
6,214,8,6007,6008,1,1,1,1,1,1,1,1,1,1,1,1,1,1,2
6,215,8,6007,6008,1,1,1,1,1,1,1,1,1,1,1,1,1,1,2
6,216,8,6007,6008,1,1,1,1,1,1,1,1,1,1,1,1,1,1,2
6,217,8,6007,6008,1,1,1,1,1,1,1,1,1,1,1,1,1,1,2
6,218,8,6007,6008,1,1,1,1,1,1,1,1,1,1,1,1,1,1,2
6,219,8,6007,6008,1,1,1,1,1,1,1,1,1,1,1,1,1,1,2
6,220,8,6007,6008,1,1,1,1,1,1,1,1,1,1,1,1,1,1,2
6,221,8,6007,6008,1,1,1,1,1,1,1,1,1,1,1,1,1,1,2
6,222,8,6007,6008,1,1,1,1,1,1,1,1,1,1,1,1,1,1,2
6,223,8,6007,6008,1,1,1,1,1,1,1,1,1,1,1,1,1,1,2
6,224,8,6007,6008,1,1,1,1,1,1,1,1,1,1,1,1,1,1,2
6,225,8,6007,6008,1,1,1,1,1,1,1,1,1,1,1,1,1,1,2
6,226,8,6007,6008,1,1,1,1,1,1,1,1,1,1,1,1,1,1,2
6,227,8,6007,6008,1,1,1,1,1,1,1,1,1,1,1,1,1,1,2
6,228,8,6007,6008,1,1,1,1,1,1,1,1,1,1,1,1,1,1,2
6,229,8,6007,6008,1,1,1,1,1,1,1,1,1,1,1,1,1,1,2
6,230,8,6007,6008,1,1,1,1,1,1,1,1,1,1,1,1,1,1,2
6,231,8,6007,6008,1,1,1,1,1,1,1,1,1,1,1,1,1,1,2
6,232,8,6007,6008,1,1,1,1,1,1,1,1,1,1,1,1,1,1,2
6,233,8,6007,6008,1,1,1,1,1,1,1,1,1,1,1,1,1,1,2
6,234,8,6007,6008,1,1,1,1,1,1,1,1,1,1,1,1,1,1,2
6,235,8,6007,6008,1,1,1,1,1,1,1,1,1,1,1,1,1,1,2
6,236,8,6007,6008,1,1,1,1,1,1,1,1,1,1,1,1,1,1,2
6,237,8,6007,6008,1,1,1,1,1,1,1,1,1,1,1,1,1,1,2
6,238,8,6007,6008,1,1,1,1,1,1,1,1,1,1,1,1,1,1,2
6,239,8,6007,6008,1,1,1,1,1,1,1,1,1,1,1,1,1,1,2
6,240,8,6007,6008,1,1,1,1,1,1,1,1,1,1,1,1,1,1,2
6,241,8,6007,6008,1,1,1,1,1,1,1,1,1,1,1,1,1,1,2
6,242,8,6007,6008,1,1,1,1,1,1,1,1,1,1,1,1,1,1,2
6,243,8,6007,6008,1,1,1,1,1,1,1,1,1,1,1,1,1,1,2
6,244,8,6007,6008,1,1,1,1,1,1,1,1,1,1,1,1,1,1,2
6,245,8,6007,6008,1,1,1,1,1,1,1,1,1,1,1,1,1,1,2
6,246,8,6007,6008,1,1,1,1,1,1,1,1,1,1,1,1,1,1,2
6,247,8,6007,6008,1,1,1,1,1,1,1,1,1,1,1,1,1,1,2
6,248,8,6007,6008,1,1,1,1,1,1,1,1,1,1,1,1,1,1,2
6,249,8,6007,6008,1,1,1,1,1,1,1,1,1,1,1,1,1,1,2
6,250,8,6007,6008,1,1,1,1,1,1,1,1,1,1,1,1,1,1,2
6,251,8,6007,6008,1,1,1,1,1,1,1,1,1,1,1,1,1,1,2
6,252,8,6007,6008,1,1,1,1,1,1,1,1,1,1,1,1,1,1,2
6,253,8,6007,6008,1,1,1,1,1,1,1,1,1,1,1,1,1,1,2
6,254,8,6007,6008,1,1,1,1,1,1,1,1,1,1,1,1,1,1,2
6,255,8,6007,6008,1,1,1,1,1,1,1,1,1,1,1,1,1,1,2
6,256,8,6007,6008,1,1,1,1,1,1,1,1,1,1,1,1,1,1,2
6,257,8,6007,6008,1,1,1,1,1,1,1,1,1,1,1,1,1,1,2
6,258,8,6007,6008,1,1,1,1,1,1,1,1,1,1,1,1,1,1,2
6,259,8,6007,6008,1,1,1,1,1,1,1,1,1,1,1,1,1,1,2
6,260,8,6007,6008,1,1,1,1,1,1,1,1,1,1,1,1,1,1,2
6,261,8,6007,6008,1,1,1,1,1,1,1,1,1,1,1,1,1,1,2
6,262,8,6007,6008,1,1,1,1,1,1,1,1,1,1,1,1,1,1,2
6,263,8,6007,6008,1,1,1,1,1,1,1,1,1,1,1,1,1,1,2
6,264,8,6007,6008,1,1,1,1,1,1,1,1,1,1,1,1,1,1,2
6,265,8,6007,6008,1,1,1,1,1,1,1,1,1,1,1,1,1,1,2
6,266,8,6007,6008,1,1,1,1,1,1,1,1,1,1,1,1,1,1,2
6,267,8,6007,6008,1,1,1,1,1,1,1,1,1,1,1,1,1,1,2
6,268,8,6007,6008,1,1,1,1,1,1,1,1,1,1,1,1,1,1,2
6,269,8,6007,6008,1,1,1,1,1,1,1,1,1,1,1,1,1,1,2
6,270,9,6008,6009,2,1,2,2,2,2,2,1,1,1,1,1,1,1,2
6,271,9,6008,6009,2,1,2,2,2,2,2,1,1,1,1,1,1,1,2
6,272,9,6008,6009,2,1,2,2,2,2,2,1,1,1,1,1,1,1,2
6,273,9,6008,6009,2,1,2,2,2,2,2,1,1,1,1,1,1,1,2
6,274,9,6008,6009,2,1,2,2,2,2,2,1,1,1,1,1,1,1,2
6,275,9,6008,6009,2,1,2,2,2,2,2,1,1,1,1,1,1,1,2
6,276,9,6008,6009,2,1,2,2,2,2,2,1,1,1,1,1,1,1,2
6,277,10,6009,6010,1,1,1,1,1,1,1,1,1,1,1,1,1,1,2
6,278,10,6009,6010,1,1,1,1,1,1,1,1,1,1,1,1,1,1,2
6,279,10,6009,6010,1,1,1,1,1,1,1,1,1,1,1,1,1,1,2
6,280,10,6009,6010,1,1,1,1,1,1,1,1,1,1,1,1,1,1,2
6,281,10,6009,6010,1,1,1,1,1,1,1,1,1,1,1,1,1,1,2
6,282,10,6009,6010,1,1,1,1,1,1,1,1,1,1,1,1,1,1,2
6,283,10,6009,6010,1,1,1,1,1,1,1,1,1,1,1,1,1,1,2
6,284,10,6009,6010,1,1,1,1,1,1,1,1,1,1,1,1,1,1,2
6,285,10,6009,6010,1,1,1,1,1,1,1,1,1,1,1,1,1,1,2
6,286,10,6009,6010,1,1,1,1,1,1,1,1,1,1,1,1,1,1,2
6,287,10,6009,6010,1,1,1,1,1,1,1,1,1,1,1,1,1,1,2
6,288,10,6009,6010,1,1,1,1,1,1,1,1,1,1,1,1,1,1,2
6,289,10,6009,6010,1,1,1,1,1,1,1,1,1,1,1,1,1,1,2
6,290,10,6009,6010,1,1,1,1,1,1,1,1,1,1,1,1,1,1,2
6,291,10,6009,6010,1,1,1,1,1,1,1,1,1,1,1,1,1,1,2
6,292,10,6009,6010,1,1,1,1,1,1,1,1,1,1,1,1,1,1,2
6,293,10,6009,6010,1,1,1,1,1,1,1,1,1,1,1,1,1,1,2
6,294,10,6009,6010,1,1,1,1,1,1,1,1,1,1,1,1,1,1,2
6,295,10,6009,6010,1,1,1,1,1,1,1,1,1,1,1,1,1,1,2
6,296,10,6009,6010,1,1,1,1,1,1,1,1,1,1,1,1,1,1,2
6,297,10,6009,6010,1,1,1,1,1,1,1,1,1,1,1,1,1,1,2
6,298,10,6009,6010,1,1,1,1,1,1,1,1,1,1,1,1,1,1,2
6,299,10,6009,6010,1,1,1,1,1,1,1,1,1,1,1,1,1,1,2
6,300,10,6009,6010,1,1,1,1,1,1,1,1,1,1,1,1,1,1,2
6,301,10,6009,6010,1,1,1,1,1,1,1,1,1,1,1,1,1,1,2
6,302,10,6009,6010,1,1,1,1,1,1,1,1,1,1,1,1,1,1,2
6,303,10,6009,6010,1,1,1,1,1,1,1,1,1,1,1,1,1,1,2
6,304,10,6009,6010,1,1,1,1,1,1,1,1,1,1,1,1,1,1,2
6,305,10,6009,6010,1,1,1,1,1,1,1,1,1,1,1,1,1,1,2
6,306,10,6009,6010,1,1,1,1,1,1,1,1,1,1,1,1,1,1,2
6,307,10,6009,6010,1,1,1,1,1,1,1,1,1,1,1,1,1,1,2
6,308,10,6009,6010,1,1,1,1,1,1,1,1,1,1,1,1,1,1,2
6,309,10,6009,6010,1,1,1,1,1,1,1,1,1,1,1,1,1,1,2
6,310,10,6009,6010,1,1,1,1,1,1,1,1,1,1,1,1,1,1,2
6,311,10,6009,6010,1,1,1,1,1,1,1,1,1,1,1,1,1,1,2
6,312,10,6009,6010,1,1,1,1,1,1,1,1,1,1,1,1,1,1,2
6,313,10,6009,6010,1,1,1,1,1,1,1,1,1,1,1,1,1,1,2
6,314,10,6009,6010,1,1,1,1,1,1,1,1,1,1,1,1,1,1,2
6,315,10,6009,6010,1,1,1,1,1,1,1,1,1,1,1,1,1,1,2
6,316,10,6009,6010,1,1,1,1,1,1,1,1,1,1,1,1,1,1,2
6,317,10,6009,6010,1,1,1,1,1,1,1,1,1,1,1,1,1,1,2
6,318,10,6009,6010,1,1,1,1,1,1,1,1,1,1,1,1,1,1,2
6,319,10,6009,6010,1,1,1,1,1,1,1,1,1,1,1,1,1,1,2
6,320,10,6009,6010,1,1,1,1,1,1,1,1,1,1,1,1,1,1,2
6,321,10,6009,6010,1,1,1,1,1,1,1,1,1,1,1,1,1,1,2
6,322,10,6009,6010,1,1,1,1,1,1,1,1,1,1,1,1,1,1,2
6,323,10,6009,6010,1,1,1,1,1,1,1,1,1,1,1,1,1,1,2
6,324,10,6009,6010,1,1,1,1,1,1,1,1,1,1,1,1,1,1,2
6,325,10,6009,6010,1,1,1,1,1,1,1,1,1,1,1,1,1,1,2
6,326,10,6009,6010,1,1,1,1,1,1,1,1,1,1,1,1,1,1,2
6,327,10,6009,6010,1,1,1,1,1,1,1,1,1,1,1,1,1,1,2
6,328,10,6009,6010,1,1,1,1,1,1,1,1,1,1,1,1,1,1,2
6,329,10,6009,6010,1,1,1,1,1,1,1,1,1,1,1,1,1,1,2
6,330,10,6009,6010,1,1,1,1,1,1,1,1,1,1,1,1,1,1,2
6,331,10,6009,6010,1,1,1,1,1,1,1,1,1,1,1,1,1,1,2
6,332,10,6009,6010,1,1,1,1,1,1,1,1,1,1,1,1,1,1,2
6,333,10,6009,6010,1,1,1,1,1,1,1,1,1,1,1,1,1,1,2
6,334,10,6009,6010,1,1,1,1,1,1,1,1,1,1,1,1,1,1,2
6,335,10,6009,6010,1,1,1,1,1,1,1,1,1,1,1,1,1,1,2
6,336,10,6009,6010,1,1,1,1,1,1,1,1,1,1,1,1,1,1,2
6,337,5,6010,6005,2,2,2,2,2,2,2,2,2,2,2,2,2,2,0
6,338,5,6010,6005,2,2,2,2,2,2,2,2,2,2,2,2,2,2,0
6,339,5,6010,6005,2,2,2,2,2,2,2,2,2,2,2,2,2,2,0
6,340,5,6010,6005,2,2,2,2,2,2,2,2,2,2,2,2,2,2,0
6,341,5,6010,6005,2,2,2,2,2,2,2,2,2,2,2,2,2,2,0
6,342,5,6010,6005,2,2,2,2,2,2,2,2,2,2,2,2,2,2,0
6,343,5,6010,6005,2,2,2,2,2,2,2,2,2,2,2,2,2,2,0
6,344,5,6010,6005,2,2,2,2,2,2,2,2,2,2,2,2,2,2,0
6,345,5,6010,6005,2,2,2,2,2,2,2,2,2,2,2,2,2,2,0
6,346,5,6010,6005,2,2,2,2,2,2,2,2,2,2,2,2,2,2,0
6,347,5,6010,6005,2,2,2,2,2,2,2,2,2,2,2,2,2,2,0
6,348,5,6010,6005,2,2,2,2,2,2,2,2,2,2,2,2,2,2,0
6,349,5,6010,6005,2,2,2,2,2,2,2,2,2,2,2,2,2,2,0
6,350,5,6010,6005,2,2,2,2,2,2,2,2,2,2,2,2,2,2,0
6,351,5,6010,6005,2,2,2,2,2,2,2,2,2,2,2,2,2,2,0
6,352,5,6010,6005,2,2,2,2,2,2,2,2,2,2,2,2,2,2,0
6,353,5,6010,6005,2,2,2,2,2,2,2,2,2,2,2,2,2,2,0
6,354,5,6010,6005,2,2,2,2,2,2,2,2,2,2,2,2,2,2,0
6,355,5,6010,6005,2,2,2,2,2,2,2,2,2,2,2,2,2,2,0
6,356,5,6010,6005,2,2,2,2,2,2,2,2,2,2,2,2,2,2,0
6,357,5,6010,6005,2,2,2,2,2,2,2,2,2,2,2,2,2,2,0
6,358,5,6010,6005,2,2,2,2,2,2,2,2,2,2,2,2,2,2,0
6,359,5,6010,6005,2,2,2,2,2,2,2,2,2,2,2,2,2,2,0
6,360,5,6010,6005,2,2,2,2,2,2,2,2,2,2,2,2,2,2,0
6,361,5,6010,6005,2,2,2,2,2,2,2,2,2,2,2,2,2,2,0
6,362,5,6010,6005,2,2,2,2,2,2,2,2,2,2,2,2,2,2,0
6,363,5,6010,6005,2,2,2,2,2,2,2,2,2,2,2,2,2,2,0
6,364,5,6010,6005,2,2,2,2,2,2,2,2,2,2,2,2,2,2,0
6,365,5,6010,6005,2,2,2,2,2,2,2,2,2,2,2,2,2,2,0
6,366,5,6010,6005,2,2,2,2,2,2,2,2,2,2,2,2,2,2,0
6,367,5,6010,6005,2,2,2,2,2,2,2,2,2,2,2,2,2,2,0
6,368,5,6010,6005,2,2,2,2,2,2,2,2,2,2,2,2,2,2,0
6,369,5,6010,6005,2,2,2,2,2,2,2,2,2,2,2,2,2,2,0
6,370,5,6010,6005,2,2,2,2,2,2,2,2,2,2,2,2,2,2,0
6,371,5,6010,6005,2,2,2,2,2,2,2,2,2,2,2,2,2,2,0
6,372,5,6010,6005,2,2,2,2,2,2,2,2,2,2,2,2,2,2,0
